#########################
#>              #   #   #
# # ######### # # # # # #
# #     #     # # # # # #
# ####### ##### # # # # #
#       # #     # #   # #
####### # # ########### #
#     #   # #       #   #
# ### ##### ##### # # # #
#   #     #       #   # #
### ################### #
#   # X         #     # #
# ### ######### # ### # #
# #   #   #     #   #   #
# # ##### # ####### #####
#         #             #
#########################